000000000000000000000000000000000000000000000000000000000000
000000000000000000000000000000000000000000000000000000000000
000000000000000000000000000000000000000000000000000000000000
000000000000000000000000000000000000000000000000000000000000
000000000000000000000000000000000000000000000000000000000000
000000000000000000000000000000000000000000000000000000000000
000000000000000000000000000000000000000000000000000000000000
000000000000000000000000000000000000000000000000000000000000
000000000000000000000000000000000000000000000000000000000000
000000000000000000000000000000000000000000000000000000000000
000000000000000000000000000000000000000000000000000000000000
000000000000000000000000000000000000000000000000000000000000
000000000000000000000000000000000000000000000000000000000000
000000000000000000000000001111111111111110000000000000000000
100000000000000000000000001111111111111110000000000000000001
100000000000000000000000001111111111111110000000000000000001
111111111111111111111111111111111111111111111111111111111111
111111111111111111111111111111111111111110000011111111111111
111111111111111111111111111111111111111110000011111111111111
111111111111111111111111111111111111111110000011111111111111