0000000000000000000000000000000000000000000000000000000000000
0000000000000000000000000000000000000000000000000000000000000
0000000000000000000000000000000000000000000000000000000000000
0000000000000000000000000000000000000000000000000000000000000
0000000000000000000000000000000000000000000000000000000000000
0000000000000000000000000000000000000000000000000000000000000
0000000000000000000000000000000000000000000000000000000000000
0000000331123211111111000000000000000000000000000000000000000
0000000001103011111111000000000000000000000000000000000000000
0000000000003000111111222222222233000000000000000000000000000
0000000000003000000000000000000000000000000000000000000000000
0000000000003000000000000000000000000000000000000000000000000
0000000000003000000000000000000000000000000000000000000000000
1110000000003000000000000011111133111111100000222222222001111
1110000000000000000000000011111133111111100000000000000001111
1110000000000000000000000011100033000111100000000000000001111
1111111111111111111111110011100033000000000000000000000001111
1111111111111111111111110011100033000000000000000000000001111
1111111111111111111111110011111111111111111111110000111111111
1111111111111111111111110011111111111111111111110000111111111