000000000000000000000000000000000000000000000000000000000000
000000000000000000000000000000000000000000000000000000000000
000000000000000000000000000000000000000000000000000000000000
000000000000000000000000000000000000000000000000000000000000
000000000000000000000000000000000000000000000000000000000000
000000000000000000000000000000000000000000000000000000000000
000000000000000000000000000000000000000111111111000011111111
000000000000000000000000000000000000000000000000000011111111
111100000000000000000000000000000000000000000000000011111111
111110000000000000000000000000000000000000000000000011111111
111100000000000000000000000000000000000000000000000011111111
111100000000000000000000000000000000000111111111111111111111
111111000000000000000000000000000000000111111111111111111111
111100000000000000000000000000000000000111111111111111111111
111100000000000000000000000000000000000000111111111111111111
111100000000000000000000001111111111111111111111111111111111
111111111111111111111111111111111111111111111111111111111111
111111111111111111111111111111111111111111111111111111111111
111111111111111111111111111111111111111111111111111111111111
111111111111111111111111111111111111111111111111111111111111