0000000000000000000000000000000000000000000000000000000000000
0000000000000000000000000000000000000000000000000000000000000
0000000000000000000000000000000000000000000000000000000000000
0000000000000000000000000000000000000000000000000000000000000
0000000000000000000000000000000000000000000000000000000000000
0000000000000000000000000000000000000000000000000000000000000
0000000000000000000000000000000000000000000000000000000000000
0000000000000000111111000000000000000000000000000000000000000
0000000000000000111111000000000000000000000000000000000000000
0000000000000000111111222222222222000000000000000000000000000
0000000000000000000000000000000000000000000000000000000000000
0000000000000000000000000000000000000000000000000000000000000
0000000000000000000000000000000000000000000000000000000000000
1110000000000000000000000011111111111111100000222222222001111
1110000000000000000000000011111111111111100000000000000001111
1110000000000000000000000011111111111111100000000000000001111
1111111111111111111111110011111111111111100000000000000001111
1111111111111111111111110011111111111111100000000000000001111
1111111111111111111111110011111111111111111111110000111111111
1111111111111111111111110011111111111111111111110000111111111