000000000000000000000000000000000000000000000000000000000000
000000000000000000000000000000000000000000000000000000000000
000000000000000000000000000000000000000000000000000000000000
000000000000000000000000000000000000000000000000000000000000
000000000000000000000000000000000000000000000000000000000000
000000000000000000000000000000000000000000000000000000000000
000000000000000000000000000000000000000111111111000011111111
000000000000000000000000000000000000000000000000000011111111
000000000000000000000000000000000000000000000000000011111111
000000000000000000000000000000000000000000000000000011111111
000000000000000000000000000000000000000000000000000011111111
000000000000000000000000000000000000000111111111111111111111
000000000000000000000000000000000000000111111111111111111111
000000000000000000000000000000000000000111111111111111111111
000000000000000000000000000000000000000111111111111111111111
000000000000000000000000001111111111111111111111111111111111
111111111111111111111111111111111111111111111111111111111111
111111111111111111111111111111111111111111111111111111111111
111111111111111111111111111111111111111111111111111111111111
111111111111111111111111111111111111111111111111111111111111