A A A A A A A A A A A A A A A A A A A A A A A A A A A A A A A A A A A A A A A A A A A A A A A A A A A A A A A A A A A A A A A A A A A A A A A A A A A A A A A A A A A A A A A A A A A A A A A A A A A A A A A A A A A A A A A A A 
A A A A A A A A A A A A A A A A A A A A A A A A A A A A A A A A A A A A A A A A A A A A A A A A A A A A A A A A A A A A A A A A A A A A A A A A A A A A A A A A A A A A A A A A A A A A A A A A A A A A A A A A A A A A A A A A A 
A A A A A A A A A A A A A A A A A A A A A A A A A A A A A A A A A A A A A A A A A A A A A A A A A A A A A A A A A A A A A A A A A A A A A A A A A A A A A A A A A A A A A A A A A A A A A A A A A A A A A A A A A A A A A A A A A 
A A A A A A A A A A A A A A A A A A A A A A A A A A A A A A A A A A A A A A A A A A A A A A A A A A A A A A A A A A A A A A A A A A A A A A A A A A A A A A A A A A A A A A A A A A A A A A A A A A A A A A A A A A A A A A A A A 
A A A A A A A A A A A A A A A A A A A A A A A A A A A A A A A A A A A A A A A A A A A A A A A A A A A A A A A A A A A A A A A A A A A A A A A A A A A A A A A A A A A A A A A A A A A A A A A A A A A A A A A A A A A A A A A A A 
B B B B B B E F G H A A A A A A A A A A A A A A A A A A A A A A A A A A A A A A A A A A A A A A A A A A A A A A A A A A A A A A A A A A A A A A A A A A A A A A A A A A A A A A A A A A A A A A A A A A A A A A A A A A A A A A A 
B B B B B B B B B B I J A A A A A A A A A A A A A A A A A A A A A A A A A A A A A A A A A A A A A A A A A A A A A A A A A A A A A A A A A A A A A A A A A A A A A A A A A A A A A A A A A A A A A A A A A A A A A A A A A A A A A
B B B B B B B B B B B B B B C C C B B B B B A A A A A A A A A A A A A A A A A A A A A A A A A A A A A A A A A A A A A A A A A A A A A A A A A A A A A A A A A A A A A A A A A A A A A A A A A A A A A A A A A A A A A A A A A A A 
B B B B B B B B B B B B B B A A A B B B B B A A A A A A A A A A A A A A A A A A A A A A A A A A A A A A A A A A A A A A A A A A A A A A A A A A A A A A A A A A A A A A A A A A A A A A A A A A A A A A A A A A A A A A A A A A A 
B B B B B B B B B B B B B B A A A B B B B B C C C C C C C C C C D D C C C C C C A A A A A A A A A A A A A A A A A C C C C C C C C A A A A A A A A A A A A A A A A A A A A A A A A A A A A A A A A A A A A A A A A A A A A A A A A 
A A A A A A A A A A A A A A A A A A A A A A A A A A A A A A A A D D A A A A A A A A A A A A A A A A A A A A A A A A A A A A A A A A A A A A A A A A A A A A A A A A A A A A A A A A A A A A A A A A A A A A A A A A A A A A A A A 
A A A A A A A A A A A A A A A A A A A A A A A A A A A A A A A A D D A A A A A A A A A A A A A A A A A A A A A A A A A A A A A A A A A A A A A A A A A A A A A A A A A A A A A A A A A A A A A A A A A A A A A A A A A A A A A A A 
A A A A A A A A A A A A A A A A A A A A A A A A A A A A A A A A A A A A A A A A A A A A A A A A A A A A A A A A A A A A A A A A A A A A A A A A A A A A A A A A A A A A A A A A A A A A A A A A A A A A A A A A A A A A A A A A A 
A A A A A A A A A A A A A A A A A A A A A A A A A A B B B B B B D D B B B B B B A A A A A A A A A A A A A K L M N B B B B B B B B E F G H A A A A A A A A A A A A A A A A A A A A A A A A A A A A A A A A A A A A A A A A A A A A
A A A A A A A A A A A A A A A A A A A A A A A A A A B B B B B B D D B B B B B B A A A A A A A A A A A O P B B B B B B B B B B B B B B B B E F G H A A A A A A A A A A A A A A A A O P B B B B B B C C C B B B B B B A A A A A A A
B B B B B B B B B B I J A A A A A A A A A A A A A A B B B A A A D D A A A A A A A A A A A A A A A O P B B B B B B B B B B B B B B B B B B B B B B I J A A A A A A A A A A A A A A B B B B B B B B A A A B B B B B B A A A A A A A
B B B B B B B B B B B B A A A A A A A A A A A A A A B B B A A A D D A A A A A A A A A A A A A O P B B B B B B B B B B B B B B B B B B B B B B B B B B B B B B B B B A A A A A A A B B B B B B B B A A A B B B B B B A A A A A A A
B B B B B B B B B B B B B B B B B B B B B B A A A A B B B A A A D D A A A A A A A A A A A O P B B B B B B B B B B B B B B B B B B B B B B B B B B B B B B B B B B B A A A A A A A B B B B B B B B A A A B B B B B B A A A A A A A
B B B B B B B B B B B B B B B B B B B B B B A A A A B B B B B B B B B B B B B B B B B B B B B B B B B B B B B B B B B B B B B B B B B B B B B B B B B B B B B B B B A A A A A A A B B B B B B B B A A A B B B B B B A A A A A A A
B B B B B B B B B B B B B B B B B B B B B B A A A A B B B B B B B B B B B B B B B B B B B B B B B B B B B B B B B B B B B B B B B B B B B B B B B B B B B B B B B B A A A A A A A B B B B B B B B A A A B B B B B B A A A A A A A 