000000000000000000000000000000000000000000000000000000000000
000000000000000000000000000000000000000000000000000000000000
000000000000000000000000000000000000000000000000000000000000
000000000000000000000000000000000000000000000000000000000000
000000000000000000000000000000000000000000000000000000000000
000000000000000000000000000000000000000000000000000000000000
000000000000000000000000000000000000000000000000000000000000
000000000000000000000000000000000100000000000000000000000000
000000000000000000000000000000000100000000000000000000000000
000000000000000000000000001110000100001110000000000000000000
000000000000000000000111111110000100001111111100000000000000
000000000000000000000000000000000000000000000000000000000000
000000000000000000000000000000000000000000000000000000000000
111000000000000000000000001111111111111110000000000000000111
111000000000000000000000001111111111111110000000000000000111
111000000000000000000000001111111111111110000000000000000111
111111111111111111111111111111111111111111111111111111111111
111111111111111111111111111111111111111110000011111111111111
111111111111111111111111111111111111111110000011111111111111
111111111111111111111111111111111111111110000011111111111111