000000000000000000000000000000000000000000000000000000000000
000000000000000000000000000000000000000000000000000000000000
000000000000000000000000000000000000000000000000000000000000
000000000000000000000000000000000000000000000000000000000000
000000000000000000000000000000000000000000000000000000000000
000000000000000000000000000000000000000000000000000000000000
000000000000000000000000000000000000000000000000000000000000
000000000000000011111100000000000000000000000000000000000000
000000000000000011111100000000000000000000000000000000000000
000000000000000011111122222222222200000000000000000000000000
000000000000000000000000000000000000000000000000000000000000
000000000000000000000000000000000000000000000000000000000000
000000000000000000000000000000000000000000000000000000000000
111000000000000000000000001111111111111110000022222222200111
111000000000000000000000001111111111111110000000000000000111
111000000000000000000000001111111111111110000000000000000111
111111111111111111111111111111111111111110000000000000000111
111111111111111111111111111111111111111110000000000000000111
111111111111111111111111111111111111111111111111111111111111
111111111111111111111111111111111111111111111111111111111111